992 480 1
000 000 000 000 000 000 000 001 000 000 000 000 000 000 000 000 000 000 000 000 000 000 000 000 000 000 000 202 000 000 000
000 000 000 000 000 201 000 001 000 000 000 000 000 000 000 000 000 000 000 000 000 000 000 000 000 000 000 000 000 000 000
000 000 000 000 000 001 000 001 000 000 000 000 000 000 000 000 000 000 000 000 000 000 000 000 000 000 000 202 000 000 000
000 000 000 000 000 001 000 001 000 000 000 000 000 000 000 000 000 000 000 000 000 000 000 000 000 000 000 000 000 000 000
000 000 000 000 000 001 000 001 000 000 000 000 000 000 000 000 000 000 000 000 000 000 000 000 000 000 000 202 000 000 000
000 000 000 000 000 001 000 001 000 000 000 000 000 000 000 000 000 000 000 000 000 000 000 000 000 000 000 000 000 000 000
000 000 000 000 203 001 000 001 000 000 000 000 000 000 000 000 000 000 000 000 000 000 000 000 000 000 000 202 000 000 000
000 000 000 000 000 001 000 001 000 000 000 000 000 000 000 000 000 000 000 000 000 000 000 000 000 000 000 000 000 000 000
000 000 000 000 000 001 000 001 000 000 000 000 000 000 000 000 000 000 000 000 000 000 203 000 000 000 000 202 000 000 001
000 000 000 202 000 001 000 001 000 000 000 000 000 203 000 000 000 000 000 000 000 000 000 000 000 000 000 000 000 000 001
000 000 000 000 000 001 000 001 000 000 000 000 000 000 000 000 000 000 000 000 000 000 000 000 000 000 000 202 000 000 001
000 000 000 000 000 001 000 001 000 000 000 000 000 000 000 000 000 000 000 000 000 000 000 000 000 000 000 000 000 000 001
000 000 000 000 000 001 000 001 000 000 000 000 000 000 000 000 000 000 203 000 000 000 000 000 000 000 000 202 000 000 001
000 -1  000 000 203 001 000 000 000 000 000 000 000 000 000 000 000 000 000 000 000 000 000 000 000 000 000 000 000 000 001
001 001 001 001 001 001 001 001 001 001 203 202 000 000 000 000 000 000 000 000 000 000 000 000 000 000 000 202 000 000 001
