832 480 1
000 000 000 000 000 000 000 000 000 000 000 000 000 000 000 000 000 000 000 000 000 000 000 000 000 000
000 000 000 001 000 000 000 000 000 000 000 000 000 000 000 000 001 000 001 000 001 000 001 000 000 000
000 000 000 001 000 000 000 000 000 000 000 000 000 000 000 000 001 000 001 000 001 000 001 000 000 000
000 000 202 001 000 000 000 000 000 000 000 000 000 000 000 203 001 000 001 000 001 000 001 000 000 000
000 000 000 001 000 000 000 000 000 000 000 000 000 000 000 000 001 000 001 000 001 000 001 000 000 000
000 000 000 001 000 000 000 000 000 000 000 000 000 000 000 000 001 000 001 000 001 000 001 000 000 000
000 000 000 001 000 000 000 000 000 000 000 000 000 000 000 000 001 000 001 000 001 000 001 000 000 000
000 000 202 001 000 000 000 000 000 000 000 000 000 000 000 203 001 000 001 000 001 000 001 000 000 000
000 000 000 001 000 000 000 000 000 000 000 000 000 000 000 000 001 000 001 000 001 000 001 000 000 000
000 000 000 001 000 000 000 000 000 000 000 000 000 000 000 000 001 000 001 000 001 000 001 000 000 000
000 000 000 001 000 000 000 000 000 000 000 000 000 000 000 000 001 000 001 000 001 000 001 000 000 000
000 000 202 001 000 000 000 000 000 000 000 000 000 000 000 203 001 000 001 000 001 000 001 000 000 000
000 000 000 001 000 000 000 000 000 000 000 000 000 000 000 000 001 000 001 000 001 000 001 000 000 000
000 -1  000 001 000 000 000 000 000 000 000 000 000 000 000 000 001 000 001 000 001 000 001 000 000 000
001 001 001 001 001 001 001 001 001 001 001 001 001 001 001 001 001 201 001 201 001 201 001 201 201 001
