1408 800 1
-1  000 000 000 000 000 000 000 000 000 000 000 000 000 000 000 000 000 000 000 000 000 000 000 000 000 000 000 000 000 000 000 000 000 000 000 000 000 000 000 000 000 000 001 
001 001 001 001 001 001 001 001 001 001 001 001 001 001 001 001 001 001 001 001 001 001 001 001 001 001 001 001 001 001 001 001 001 001 001 001 001 001 001 001 001 001 000 001 
000 000 000 000 000 000 000 000 000 000 000 000 000 000 000 000 000 000 000 000 000 000 000 000 000 000 000 000 000 000 000 000 001 000 000 000 000 000 000 000 000 001 000 001 
000 000 000 000 000 000 000 000 000 000 000 000 000 000 000 000 000 001 001 001 001 001 000 000 000 000 000 000 000 000 000 000 001 000 001 001 001 001 001 001 000 001 000 001 
000 000 001 001 001 001 001 001 001 001 001 001 001 001 001 001 001 001 000 000 000 001 000 000 000 000 000 000 000 000 000 000 001 000 001 000 000 000 000 001 000 001 000 001 
000 000 001 000 000 000 000 000 000 000 000 000 000 000 000 000 000 000 000 000 000 001 000 203 000 202 000 203 000 202 000 203 001 000 001 000 000 000 202 001 000 001 000 001 
000 000 001 000 001 001 001 001 001 001 001 001 001 001 001 001 001 001 001 001 000 001 001 001 001 001 001 001 001 001 001 001 001 000 001 000 000 000 000 001 000 001 000 001 
000 000 001 000 001 000 000 000 000 000 000 000 000 000 000 000 000 000 000 001 000 000 000 000 000 000 000 000 000 000 000 000 000 000 001 000 000 000 203 001 000 001 000 001 
000 000 001 000 001 000 000 000 000 000 000 000 000 000 000 000 000 000 202 001 000 000 000 201 000 201 000 201 000 201 000 201 000 000 001 000 000 000 000 001 000 001 000 001 
000 000 001 000 001 000 000 000 000 000 000 000 000 000 000 000 000 000 000 001 001 001 001 001 001 001 001 001 001 001 001 001 001 001 001 000 000 000 202 001 000 001 000 001 
000 203 001 000 001 202 000 000 000 000 000 000 000 000 000 000 000 000 000 000 000 000 000 000 000 000 000 000 000 000 000 000 000 000 000 000 000 000 000 001 000 001 000 001 
000 203 001 000 001 202 000 000 000 000 000 000 000 000 000 000 000 000 000 000 000 000 000 000 000 000 000 000 000 000 000 000 000 000 000 000 000 000 203 001 000 001 000 001 
000 203 001 000 001 202 000 000 000 000 000 000 000 000 000 000 000 000 000 000 000 000 000 000 000 000 000 000 000 000 000 000 000 000 000 000 000 000 000 001 000 001 000 001 
000 203 001 000 001 202 000 000 000 000 000 000 000 000 000 000 000 000 000 000 000 000 000 000 000 000 000 000 000 000 000 000 000 000 000 000 000 000 202 001 000 001 000 001 
000 203 001 000 001 202 000 000 000 000 000 000 000 000 000 000 000 000 000 000 000 000 000 000 000 000 000 000 000 000 000 000 000 000 000 000 000 000 000 001 000 001 000 001 
000 203 001 000 001 202 000 000 000 000 000 000 000 000 000 000 000 000 000 000 000 000 000 000 000 000 000 000 000 000 000 000 000 000 000 000 000 000 203 001 000 001 000 001 
000 203 001 000 001 202 000 000 000 000 000 000 000 000 000 203 000 000 000 000 202 000 000 000 000 202 000 000 000 202 000 000 000 000 000 000 000 000 000 001 000 001 000 001 
000 203 001 000 001 202 000 000 000 000 000 000 000 000 000 000 000 000 000 000 000 000 000 000 000 000 000 000 000 000 203 000 000 000 000 000 000 000 202 001 000 001 000 001 
000 203 001 000 001 202 000 000 000 000 000 000 000 000 000 000 000 000 000 000 000 000 000 000 000 000 000 000 000 000 000 202 000 000 000 000 000 000 000 001 000 001 000 001 
000 203 001 000 001 202 000 000 000 000 000 000 203 000 000 000 000 000 000 000 000 000 000 000 000 000 000 000 000 000 000 000 000 000 000 000 000 000 203 001 000 001 000 001 
000 203 001 000 001 202 000 000 000 000 000 000 000 000 000 000 000 000 000 000 000 000 000 000 000 000 000 000 000 000 000 000 000 000 000 000 000 000 000 001 000 001 000 001 
000 203 001 000 001 202 000 000 000 000 000 000 000 000 000 000 000 000 000 000 000 000 000 000 000 000 000 000 000 000 000 000 000 000 000 000 000 000 202 001 000 000 000 001 
000 000 001 000 001 000 000 000 000 202 000 000 000 000 000 000 000 000 000 000 000 000 000 000 000 000 000 000 000 000 000 000 000 000 000 000 000 000 000 001 001 001 001 001 
000 000 001 000 000 000 000 000 000 000 201 201 201 201 201 201 201 201 201 201 201 201 201 201 201 201 201 201 201 201 201 201 201 000 000 000 000 000 000 000 000 000 000 000 
000 000 001 001 001 001 001 001 001 001 001 001 001 001 001 001 001 001 001 001 001 001 001 001 001 001 001 001 001 001 001 001 001 001 001 001 001 001 001 001 001 001 001 001 