704 480 1
000 000 000 000 000 000 000 000 000 000 000 000 000 000 000 000 000 000 000 000 000 001 
000 000 000 000 000 000 000 000 000 000 000 000 000 000 000 000 000 000 000 000 000 001
000 000 000 000 000 000 000 000 000 000 000 000 000 000 000 000 000 000 000 000 000 001
000 000 000 000 000 000 000 000 000 000 000 000 000 000 000 000 000 000 000 000 000 001
000 000 000 000 000 000 000 000 000 000 000 000 000 000 000 000 000 000 000 000 000 001
000 000 000 000 000 000 000 000 000 000 000 000 000 000 000 000 000 000 000 000 201 001
000 000 000 000 000 000 000 000 000 000 000 000 000 000 000 201 201 201 201 000 000 001
000 000 000 000 000 000 000 000 000 000 000 000 000 000 000 202 203 202 203 202 000 001
000 000 000 000 000 000 000 000 000 000 000 201 000 201 000 201 000 000 000 000 000 001
000 000 000 000 000 000 000 201 000 201 000 202 000 203 203 201 000 000 000 000 000 001
000 000 000 201 000 201 000 202 000 203 000 000 000 000 000 000 000 000 000 000 000 001
000 000 202 202 000 203 000 000 000 000 000 000 000 000 000 000 000 000 000 000 000 001
000 000 000 000 000 000 000 000 000 000 000 000 000 000 000 000 000 000 000 000 000 001
-1  000 201 201 201 201 201 201 201 201 201 201 201 201 201 201 201 201 201 201 000 000
001 001 001 001 001 001 001 001 001 001 001 001 001 001 001 001 001 001 001 001 001 001
